ROCHAEL	( MICHAEL | MICHELLE -> ROCHELLE )
MECHAEL	( MICHAEL | MICHELLE -> MECHELLE )
MACHAEL	( MICHAEL | MICHELLE -> MACHELLE )
LACHAEL	( MICHAEL | MICHELLE -> LACHELLE )
MARCHAEL	( MICHAEL | MICHELLE -> MARCHELLE )
COLLIAM	( WILLIAM | WILLETTE -> COLLETTE )
ROCHARD	( RICHARD | RICHELLE -> ROCHELLE )
RACHARD	( RICHARD | RICHELLE -> RACHELLE )
MECHARD	( RICHARD | RICHELLE -> MECHELLE )
MACHARD	( RICHARD | RICHELLE -> MACHELLE )
LACHARD	( RICHARD | RICHELLE -> LACHELLE )
MARCHARD	( RICHARD | RICHELLE -> MARCHELLE )
PEARLES	( CHARLES | CHARLENE -> PEARLENE )
CLARLES	( CHARLES | CHARISSA -> CLARISSA )
STEPH	( JOSEPH | JOSEPHINE -> STEPHINE )
DANNIEL	( DANIEL | DANIELLE -> DANNIELLE )
LORRY	( LARRY | LARRAINE -> LORRAINE )
JOSEPHEN	( STEPHEN | STEPHINE -> JOSEPHINE )
COLLIE	( WILLIE | WILLETTE -> COLLETTE )
ROCHOLAS	( NICHOLAS | NICHELLE -> ROCHELLE )
RACHOLAS	( NICHOLAS | NICHELLE -> RACHELLE )
MECHOLAS	( NICHOLAS | NICHELLE -> MECHELLE )
MACHOLAS	( NICHOLAS | NICHELLE -> MACHELLE )
LACHOLAS	( NICHOLAS | NICHELLE -> LACHELLE )
MARCHOLAS	( NICHOLAS | NICHELLE -> MARCHELLE )
CELEST	( ERNEST | ERNESTINE -> CELESTINE )
CHARENCE	( CLARENCE | CLARISSA -> CHARISSA )
MARGARENCE	( CLARENCE | CLARETTA -> MARGARETTA )
ANTIONIO	( ANTONIO | ANTONETTE -> ANTIONETTE )
LYNNY	( DANNY | DANNETTE -> LYNNETTE )
ADRIO	( MARIO | MARIANNE -> ADRIANNE )
HENRIO	( MARIO | MARIETTA -> HENRIETTA )
GABRIO	( MARIO | MARIELLE -> GABRIELLE )
HARRIO	( MARIO | MARIETTE -> HARRIETTE )
ROCHEAL	( MICHEAL | MICHELLE -> ROCHELLE )
MECHEAL	( MICHEAL | MICHELLE -> MECHELLE )
MACHEAL	( MICHEAL | MICHELLE -> MACHELLE )
LACHEAL	( MICHEAL | MICHELLE -> LACHELLE )
MARCHEAL	( MICHEAL | MICHELLE -> MARCHELLE )
CLARLIE	( CHARLIE | CHARISSA -> CLARISSA )
ADALBERT	( GILBERT | GILBERTO -> ADALBERTO )
COLLARD	( WILLARD | WILLETTE -> COLLETTE )
ADRION	( MARION | MARIANNE -> ADRIANNE )
HENRION	( MARION | MARIETTA -> HENRIETTA )
GABRION	( MARION | MARIELLE -> GABRIELLE )
HARRION	( MARION | MARIETTE -> HARRIETTE )
LYNNIE	( DONNIE | DONNETTE -> LYNNETTE )
JEANNON	( SHANNON | SHANELLE -> JEANELLE )
CELESTO	( ERNESTO | ERNESTINE -> CELESTINE )
COLLIS	( WILLIS | WILLETTE -> COLLETTE )
CHARK	( CLARK | CLARISSA -> CHARISSA )
MARGARK	( CLARK | CLARETTA -> MARGARETTA )
CHAROLAS	( NICOLAS | NICOLETTE -> CHAROLETTE )
VIOLAS	( NICOLAS | NICOLETTE -> VIOLETTE )
JOSEPHAN	( STEPHAN | STEPHINE -> JOSEPHINE )
FAUST	( AUGUST | AUGUSTINA -> FAUSTINA )
FAUSTIN	( AGUSTIN | AGUSTINA -> FAUSTINA )
HENRISON	( HARRISON | HARRIETTE -> HENRIETTE )
MARISON	( HARRISON | HARRIETTE -> MARIETTE )
ANTION	( ANTON | ANTONETTE -> ANTIONETTE )
COLLIAMS	( WILLIAMS | WILLETTE -> COLLETTE )
MECHEL	( MICHEL | MICHELLE -> MECHELLE )
MACHEL	( MICHEL | MICHELLE -> MACHELLE )
LACHEL	( MICHEL | MICHELLE -> LACHELLE )
MARCHEL	( MICHEL | MICHELLE -> MARCHELLE )
JEANNELL	( DONNELL | DONNETTE -> JEANNETTE )
LYNNELL	( DONNELL | DONNETTE -> LYNNETTE )
JANNELL	( DONNELL | DONNETTE -> JANNETTE )
NANNELL	( DONNELL | DONNETTE -> NANNETTE )
DANNELL	( DONNELL | DONNETTE -> DANNETTE )
VALENT	( CLEMENT | CLEMENTINE -> VALENTINE )
FLORENT	( CLEMENT | CLEMENTINA -> FLORENTINA )
ARGENT	( CLEMENT | CLEMENTINA -> ARGENTINA )
JEANNY	( DONNY | DONNETTE -> JEANNETTE )
JANNY	( DONNY | DONNETTE -> JANNETTE )
NANNY	( DONNY | DONNETTE -> NANNETTE )
RODERIC	( FREDERIC | FREDERICK -> RODERICK )
BRODERIC	( FREDERIC | FREDERICK -> BRODERICK )
PEARLEY	( CHARLEY | CHARLENE -> PEARLENE )
CLARLEY	( CHARLEY | CHARISSA -> CLARISSA )
HENRIS	( HARRIS | HARRIETTE -> HENRIETTE )
WILLIN	( COLLIN | COLLETTE -> WILLETTE )
ADRIANO	( MARIANO | MARIANNE -> ADRIANNE )
HENRIANO	( MARIANO | MARIETTA -> HENRIETTA )
GABRIANO	( MARIANO | MARIELLE -> GABRIELLE )
HARRIANO	( MARIANO | MARIETTE -> HARRIETTE )
DANNIAL	( DANIAL | DANIELLE -> DANNIELLE )
CHARMAN	( GERMAN | GERMAINE -> CHARMAINE )
SHARMAN	( GERMAN | GERMAINE -> SHARMAINE )
JAQUES	( JACQUES | JACQUELINE -> JAQUELINE )
JACKQUES	( JACQUES | JACQUELINE -> JACKQUELINE )
MARQUES	( JACQUES | JACQUETTA -> MARQUETTA )
ANTIONY	( ANTONY | ANTONETTE -> ANTIONETTE )
FAUSTINE	( AUGUSTINE | AUGUSTINA -> FAUSTINA )
JOHNAS	( JONAS | JONATHAN -> JOHNATHAN )
CLEMENTIN	( VALENTIN | VALENTINE -> CLEMENTINE )
FLORENTIN	( VALENTIN | VALENTINA -> FLORENTINA )
ARGENTIN	( VALENTIN | VALENTINA -> ARGENTINA )
JEANCE	( CHANCE | CHANELLE -> JEANELLE )
JACQUIS	( MARQUIS | MARQUETTA -> JACQUETTA )
CLARITO	( MARGARITO | MARGARETTA -> CLARETTA )
AGUSTINO	( FAUSTINO | FAUSTINA -> AGUSTINA )
AUGUSTINO	( FAUSTINO | FAUSTINA -> AUGUSTINA )
HENRIA	( MARIA | MARIETTA -> HENRIETTA )
GABRIA	( MARIA | MARIELLE -> GABRIELLE )
HARRIA	( MARIA | MARIETTE -> HARRIETTE )
JEANG	( CHANG | CHANELLE -> JEANELLE )
FAUSTUS	( AUGUSTUS | AUGUSTINA -> FAUSTINA )
DANIE	( DANNIE | DANNIELLE -> DANIELLE )
ROCHIE	( RICHIE | RICHELLE -> ROCHELLE )
RACHIE	( RICHIE | RICHELLE -> RACHELLE )
MECHIE	( RICHIE | RICHELLE -> MECHELLE )
MACHIE	( RICHIE | RICHELLE -> MACHELLE )
LACHIE	( RICHIE | RICHELLE -> LACHELLE )
MARCHIE	( RICHIE | RICHELLE -> MARCHELLE )
JOHNAH	( JONAH | JONATHAN -> JOHNATHAN )
COLLY	( WILLY | WILLETTE -> COLLETTE )
VALENCIO	( FLORENCIO | FLORENTINA -> VALENTINA )
CLEMENCIO	( FLORENCIO | FLORENTINA -> CLEMENTINA )
ARGENCIO	( FLORENCIO | FLORENTINA -> ARGENTINA )
FLORENTINE	( VALENTINE | VALENTINA -> FLORENTINA )
ARGENTINE	( VALENTINE | VALENTINA -> ARGENTINA )
ANTIONIA	( ANTONIA | ANTONETTE -> ANTIONETTE )
VALENTINO	( FLORENTINO | FLORENTINA -> VALENTINA )
CLEMENTINO	( FLORENTINO | FLORENTINA -> CLEMENTINA )
ARGENTINO	( FLORENTINO | FLORENTINA -> ARGENTINA )
VALENTE	( CLEMENTE | CLEMENTINE -> VALENTINE )
FLORENTE	( CLEMENTE | CLEMENTINA -> FLORENTINA )
ARGENTE	( CLEMENTE | CLEMENTINA -> ARGENTINA )
DANNILO	( DANILO | DANIELLE -> DANNIELLE )
AGUSTO	( FAUSTO | FAUSTINA -> AGUSTINA )
AUGUSTO	( FAUSTO | FAUSTINA -> AUGUSTINA )
ROCHALE	( MICHALE | MICHELLE -> ROCHELLE )
RACHALE	( MICHALE | MICHELLE -> RACHELLE )
MECHALE	( MICHALE | MICHELLE -> MECHELLE )
MACHALE	( MICHALE | MICHELLE -> MACHELLE )
LACHALE	( MICHALE | MICHELLE -> LACHELLE )
MARCHALE	( MICHALE | MICHELLE -> MARCHELLE )
COLLIAN	( WILLIAN | WILLETTE -> COLLETTE )
ROCHAL	( MICHAL | MICHELLE -> ROCHELLE )
MECHAL	( MICHAL | MICHELLE -> MECHELLE )
MACHAL	( MICHAL | MICHELLE -> MACHELLE )
LACHAL	( MICHAL | MICHELLE -> LACHELLE )
MARCHAL	( MICHAL | MICHELLE -> MARCHELLE )
JEANNIFER	( JENNIFER | JENNETTE -> JEANNETTE )
LYNNIFER	( JENNIFER | JENNETTE -> LYNNETTE )
JANNIFER	( JENNIFER | JENNETTE -> JANNETTE )
NANNIFER	( JENNIFER | JENNETTE -> NANNETTE )
DANNIFER	( JENNIFER | JENNETTE -> DANNETTE )
DONNIFER	( JENNIFER | JENNETTE -> DONNETTE )
CLARET	( MARGARET | MARGARETTA -> CLARETTA )
NANNA	( DONNA | DONNETTE -> NANNETTE )
PEARON	( SHARON | SHARLENE -> PEARLENE )
JOSEPHANIE	( STEPHANIE | STEPHINE -> JOSEPHINE )
ADRIE	( MARIE | MARIANNE -> ADRIANNE )
HENRIE	( MARIE | MARIETTA -> HENRIETTA )
GABRIE	( MARIE | MARIELLE -> GABRIELLE )
HARRIE	( MARIE | MARIETTE -> HARRIETTE )
CHAROLE	( NICOLE | NICOLETTE -> CHAROLETTE )
VIOLE	( NICOLE | NICOLETTE -> VIOLETTE )
RICHEL	( RACHEL | RACHELLE -> RICHELLE )
NICHEL	( RACHEL | RACHELLE -> NICHELLE )
ADRILYN	( MARILYN | MARIANNE -> ADRIANNE )
HENRILYN	( MARILYN | MARIETTA -> HENRIETTA )
GABRILYN	( MARILYN | MARIELLE -> GABRIELLE )
HARRILYN	( MARILYN | MARIETTE -> HARRIETTE )
MARQUELINE	( JACQUELINE | JACQUETTA -> MARQUETTA )
VALENCE	( FLORENCE | FLORENTINA -> VALENTINA )
CLEMENCE	( FLORENCE | FLORENTINA -> CLEMENTINA )
ARGENCE	( FLORENCE | FLORENTINA -> ARGENTINA )
STEFFANY	( TIFFANY | TIFFANIE -> STEFFANIE )
PEARLOTTE	( CHARLOTTE | CHARLENE -> PEARLENE )
CLARLOTTE	( CHARLOTTE | CHARISSA -> CLARISSA )
MARGARA	( CLARA | CLARETTA -> MARGARETTA )
ROCHELE	( MICHELE | MICHELLE -> ROCHELLE )
MECHELE	( MICHELE | MICHELLE -> MECHELLE )
MACHELE	( MICHELE | MICHELLE -> MACHELLE )
LACHELE	( MICHELE | MICHELLE -> LACHELLE )
MARCHELE	( MICHELE | MICHELLE -> MARCHELLE )
DOMONICA	( VERONICA | VERONIQUE -> DOMONIQUE )
SHANETTE	( JEANETTE | JEANELLE -> SHANELLE )
CHANETTE	( JEANETTE | JEANELLE -> CHANELLE )
ANJANNE	( JEANNE | JEANETTE -> ANJANETTE )
JENNE	( JEANNE | JEANNETTE -> JENNETTE )
DONNE	( JEANNE | JEANNETTE -> DONNETTE )
SHANNE	( JEANNE | JEANELLE -> SHANELLE )
CHANNE	( JEANNE | JEANELLE -> CHANELLE )
ANNEMARY	( ROSEMARY | ROSEMARIE -> ANNEMARIE )
CLARLENE	( CHARLENE | CHARISSA -> CLARISSA )
CHARL	( PEARL | PEARLENE -> CHARLENE )
SHARL	( PEARL | PEARLENE -> SHARLENE )
WILLEEN	( COLLEEN | COLLETTE -> WILLETTE )
CHAROLA	( VIOLA | VIOLETTE -> CHAROLETTE )
HENRIAN	( MARIAN | MARIETTA -> HENRIETTA )
GABRIAN	( MARIAN | MARIELLE -> GABRIELLE )
HARRIAN	( MARIAN | MARIETTE -> HARRIETTE )
JENIE	( JENNIE | JENNIFFER -> JENIFFER )
NICOLET	( VIOLET | VIOLETTE -> NICOLETTE )
CHAROLET	( VIOLET | VIOLETTE -> CHAROLETTE )
HENRIET	( HARRIET | HARRIETTE -> HENRIETTE )
MARIET	( HARRIET | HARRIETTE -> MARIETTE )
ANJANNETTE	( JEANNETTE | JEANETTE -> ANJANETTE )
SHANNETTE	( JEANNETTE | JEANELLE -> SHANELLE )
CHANNETTE	( JEANNETTE | JEANELLE -> CHANELLE )
JANNE	( LYNNE | LYNNETTE -> JANNETTE )
NANNE	( LYNNE | LYNNETTE -> NANNETTE )
DANNE	( LYNNE | LYNNETTE -> DANNETTE )
HENRIANNE	( MARIANNE | MARIETTA -> HENRIETTA )
GABRIANNE	( MARIANNE | MARIELLE -> GABRIELLE )
HARRIANNE	( MARIANNE | MARIETTE -> HARRIETTE )
JACKQUELYN	( JACQUELYN | JACQUELINE -> JACKQUELINE )
MARQUELYN	( JACQUELYN | JACQUETTA -> MARQUETTA )
MARIENNE	( ADRIENNE | ADRIANNE -> MARIANNE )
ROCHOLE	( NICHOLE | NICHELLE -> ROCHELLE )
RACHOLE	( NICHOLE | NICHELLE -> RACHELLE )
MECHOLE	( NICHOLE | NICHELLE -> MECHELLE )
MACHOLE	( NICHOLE | NICHELLE -> MACHELLE )
LACHOLE	( NICHOLE | NICHELLE -> LACHELLE )
MARCHOLE	( NICHOLE | NICHELLE -> MARCHELLE )
RICHAEL	( RACHAEL | RACHELLE -> RICHELLE )
NICHAEL	( RACHAEL | RACHELLE -> NICHELLE )
HARRIETTA	( HENRIETTA | HENRIETTE -> HARRIETTE )
ANJANNIE	( JEANNIE | JEANETTE -> ANJANETTE )
SHANNIE	( JEANNIE | JEANELLE -> SHANELLE )
CHANNIE	( JEANNIE | JEANELLE -> CHANELLE )
PEARI	( SHARI | SHARLENE -> PEARLENE )
ADRINA	( MARINA | MARIANNE -> ADRIANNE )
HENRINA	( MARINA | MARIETTA -> HENRIETTA )
GABRINA	( MARINA | MARIELLE -> GABRIELLE )
HARRINA	( MARINA | MARIETTE -> HARRIETTE )
ERNESTE	( CELESTE | CELESTINE -> ERNESTINE )
EARNESTE	( CELESTE | CELESTINE -> EARNESTINE )
ADRISSA	( MARISSA | MARIANNE -> ADRIANNE )
HENRISSA	( MARISSA | MARIETTA -> HENRIETTA )
GABRISSA	( MARISSA | MARIELLE -> GABRIELLE )
HARRISSA	( MARISSA | MARIETTE -> HARRIETTE )
ALESSIE	( CASSIE | CASSANDRA -> ALESSANDRA )
KYMBERLEY	( KIMBERLEY | KIMBERLY -> KYMBERLY )
KEMBERLEY	( KIMBERLEY | KIMBERLY -> KEMBERLY )
ADRIBEL	( MARIBEL | MARIANNE -> ADRIANNE )
HENRIBEL	( MARIBEL | MARIETTA -> HENRIETTA )
GABRIBEL	( MARIBEL | MARIELLE -> GABRIELLE )
HARRIBEL	( MARIBEL | MARIETTE -> HARRIETTE )
ADRISA	( MARISA | MARIANNE -> ADRIANNE )
HENRISA	( MARISA | MARIETTA -> HENRIETTA )
GABRISA	( MARISA | MARIELLE -> GABRIELLE )
HARRISA	( MARISA | MARIETTE -> HARRIETTE )
PEARITY	( CHARITY | CHARLENE -> PEARLENE )
CLARITY	( CHARITY | CHARISSA -> CLARISSA )
ADRISOL	( MARISOL | MARIANNE -> ADRIANNE )
HENRISOL	( MARISOL | MARIETTA -> HENRIETTA )
GABRISOL	( MARISOL | MARIELLE -> GABRIELLE )
HARRISOL	( MARISOL | MARIETTE -> HARRIETTE )
CHARICE	( CLARICE | CLARISSA -> CHARISSA )
MARGARICE	( CLARICE | CLARETTA -> MARGARETTA )
ANJANINE	( JEANINE | JEANETTE -> ANJANETTE )
SHANINE	( JEANINE | JEANELLE -> SHANELLE )
CHANINE	( JEANINE | JEANELLE -> CHANELLE )
ADRITZA	( MARITZA | MARIANNE -> ADRIANNE )
HENRITZA	( MARITZA | MARIETTA -> HENRIETTA )
GABRITZA	( MARITZA | MARIELLE -> GABRIELLE )
HARRITZA	( MARITZA | MARIETTE -> HARRIETTE )
ANJANNINE	( JEANNINE | JEANETTE -> ANJANETTE )
LYNNINE	( JEANNINE | JEANNETTE -> LYNNETTE )
DONNINE	( JEANNINE | JEANNETTE -> DONNETTE )
SHANNINE	( JEANNINE | JEANELLE -> SHANELLE )
CHANNINE	( JEANNINE | JEANELLE -> CHANELLE )
COLLA	( WILLA | WILLETTE -> COLLETTE )
WINIE	( WINNIE | WINNIFRED -> WINIFRED )
MADALENA	( MAGDALENA | MAGDALENE -> MADALENE )
MARGARISSA	( CLARISSA | CLARETTA -> MARGARETTA )
PEARRON	( SHARRON | SHARLENE -> PEARLENE )
JEANDRA	( CHANDRA | CHANELLE -> JEANELLE )
ANJANIE	( JEANIE | JEANETTE -> ANJANETTE )
SHANIE	( JEANIE | JEANELLE -> SHANELLE )
CHANIE	( JEANIE | JEANELLE -> CHANELLE )
HENRIETT	( HARRIETT | HARRIETTE -> HENRIETTE )
MARIETT	( HARRIETT | HARRIETTE -> MARIETTE )
SHARLIE	( PEARLIE | PEARLENE -> SHARLENE )
CHARE	( CLARE | CLARISSA -> CHARISSA )
MARGARE	( CLARE | CLARETTA -> MARGARETTA )
LARRIE	( LORRIE | LORRAINE -> LARRAINE )
ADRICELA	( MARICELA | MARIANNE -> ADRIANNE )
HENRICELA	( MARICELA | MARIETTA -> HENRIETTA )
GABRICELA	( MARICELA | MARIELLE -> GABRIELLE )
HARRICELA	( MARICELA | MARIETTE -> HARRIETTE )
PEARMAINE	( CHARMAINE | CHARLENE -> PEARLENE )
CLARMAINE	( CHARMAINE | CHARISSA -> CLARISSA )
ADRIETTA	( MARIETTA | MARIANNE -> ADRIANNE )
GABRIETTA	( MARIETTA | MARIELLE -> GABRIELLE )
FAUSTA	( AUGUSTA | AUGUSTINA -> FAUSTINA )
HENRIANA	( MARIANA | MARIETTA -> HENRIETTA )
GABRIANA	( MARIANA | MARIELLE -> GABRIELLE )
HARRIANA	( MARIANA | MARIETTE -> HARRIETTE )
JACQUITA	( MARQUITA | MARQUETTA -> JACQUETTA )
ANNABELLA	( ISABELLA | ISABELLE -> ANNABELLE )
MECHELL	( MICHELL | MICHELLE -> MECHELLE )
MACHELL	( MICHELL | MICHELLE -> MACHELLE )
LACHELL	( MICHELL | MICHELLE -> LACHELLE )
MARCHELL	( MICHELL | MICHELLE -> MARCHELLE )
KYMBERLEE	( KIMBERLEE | KIMBERLY -> KYMBERLY )
KEMBERLEE	( KIMBERLEE | KIMBERLY -> KEMBERLY )
ROCHAELA	( MICHAELA | MICHELLE -> ROCHELLE )
RACHAELA	( MICHAELA | MICHELLE -> RACHELLE )
MECHAELA	( MICHAELA | MICHELLE -> MECHELLE )
MACHAELA	( MICHAELA | MICHELLE -> MACHELLE )
LACHAELA	( MICHAELA | MICHELLE -> LACHELLE )
MARCHAELA	( MICHAELA | MICHELLE -> MARCHELLE )
JAQULINE	( JACQULINE | JACQUELINE -> JAQUELINE )
JACKQULINE	( JACQULINE | JACQUELINE -> JACKQUELINE )
MARQULINE	( JACQULINE | JACQUETTA -> MARQUETTA )
MAYBETH	( MARYBETH | MARYBELLE -> MAYBELLE )
ANJANNA	( JEANNA | JEANETTE -> ANJANETTE )
CHANNA	( JEANNA | JEANELLE -> CHANELLE )
HENRIANNA	( MARIANNA | MARIETTA -> HENRIETTA )
GABRIANNA	( MARIANNA | MARIELLE -> GABRIELLE )
HARRIANNA	( MARIANNA | MARIETTE -> HARRIETTE )
RICHEAL	( RACHEAL | RACHELLE -> RICHELLE )
NICHEAL	( RACHEAL | RACHELLE -> NICHELLE )
JEANTEL	( CHANTEL | CHANELLE -> JEANELLE )
ADRISELA	( MARISELA | MARIANNE -> ADRIANNE )
HENRISELA	( MARISELA | MARIETTA -> HENRIETTA )
GABRISELA	( MARISELA | MARIELLE -> GABRIELLE )
HARRISELA	( MARISELA | MARIETTE -> HARRIETTE )
ADRILYNN	( MARILYNN | MARIANNE -> ADRIANNE )
HENRILYNN	( MARILYNN | MARIETTA -> HENRIETTA )
GABRILYNN	( MARILYNN | MARIELLE -> GABRIELLE )
HARRILYNN	( MARILYNN | MARIETTE -> HARRIETTE )
DANNIELA	( DANIELA | DANIELLE -> DANNIELLE )
JEANDA	( SHANDA | SHANELLE -> JEANELLE )
LARRI	( LORRI | LORRAINE -> LARRAINE )
ARGENCIA	( VALENCIA | VALENTINA -> ARGENTINA )
PEARLA	( CHARLA | CHARLENE -> PEARLENE )
CLARLA	( CHARLA | CHARISSA -> CLARISSA )
STEFFANI	( TIFFANI | TIFFANIE -> STEFFANIE )
SHARLINE	( PEARLINE | PEARLENE -> SHARLENE )
DANNITA	( DANITA | DANIELLE -> DANNIELLE )
JAQUELIN	( JACQUELIN | JACQUELINE -> JAQUELINE )
JACKQUELIN	( JACQUELIN | JACQUELINE -> JACKQUELINE )
MARQUELIN	( JACQUELIN | JACQUETTA -> MARQUETTA )
ADRIAH	( MARIAH | MARIANNE -> ADRIANNE )
HENRIAH	( MARIAH | MARIETTA -> HENRIETTA )
GABRIAH	( MARIAH | MARIELLE -> GABRIELLE )
HARRIAH	( MARIAH | MARIETTE -> HARRIETTE )
JEANON	( SHANON | SHANELLE -> JEANELLE )
JOSEPHANY	( STEPHANY | STEPHINE -> JOSEPHINE )
MADA	( MAGDA | MAGDALENE -> MADALENE )
JAQUE	( JACQUE | JACQUELINE -> JAQUELINE )
JACKQUE	( JACQUE | JACQUELINE -> JACKQUELINE )
MARQUE	( JACQUE | JACQUETTA -> MARQUETTA )
JOSEPHENIE	( STEPHENIE | STEPHINE -> JOSEPHINE )
PEARONDA	( SHARONDA | SHARLENE -> PEARLENE )
ADRIAM	( MARIAM | MARIANNE -> ADRIANNE )
HENRIAM	( MARIAM | MARIETTA -> HENRIETTA )
GABRIAM	( MARIAM | MARIELLE -> GABRIELLE )
HARRIAM	( MARIAM | MARIETTE -> HARRIETTE )
NICOLETA	( VIOLETA | VIOLETTE -> NICOLETTE )
CHAROLETA	( VIOLETA | VIOLETTE -> CHAROLETTE )
PEARLEEN	( CHARLEEN | CHARLENE -> PEARLENE )
CLARLEEN	( CHARLEEN | CHARISSA -> CLARISSA )
ROSAMARIE	( ANNAMARIE | ANNAMARIA -> ROSAMARIA )
PEARYN	( SHARYN | SHARLENE -> PEARLENE )
JEANTAL	( CHANTAL | CHANELLE -> JEANELLE )
ANJANA	( JEANA | JEANETTE -> ANJANETTE )
CLARLINE	( CHARLINE | CHARISSA -> CLARISSA )
JEANEL	( CHANEL | CHANELLE -> JEANELLE )
JEANTA	( SHANTA | SHANELLE -> JEANELLE )
ADRIANN	( MARIANN | MARIANNE -> ADRIANNE )
HENRIANN	( MARIANN | MARIETTA -> HENRIETTA )
GABRIANN	( MARIANN | MARIELLE -> GABRIELLE )
HARRIANN	( MARIANN | MARIETTE -> HARRIETTE )
JEANTE	( SHANTE | SHANELLE -> JEANELLE )
PEARISSE	( CHARISSE | CHARLENE -> PEARLENE )
CLARISSE	( CHARISSE | CHARISSA -> CLARISSA )
ADRILEE	( MARILEE | MARIANNE -> ADRIANNE )
HENRILEE	( MARILEE | MARIETTA -> HENRIETTA )
GABRILEE	( MARILEE | MARIELLE -> GABRIELLE )
HARRILEE	( MARILEE | MARIETTE -> HARRIETTE )
ADRITA	( MARITA | MARIANNE -> ADRIANNE )
HENRITA	( MARITA | MARIETTA -> HENRIETTA )
GABRITA	( MARITA | MARIELLE -> GABRIELLE )
HARRITA	( MARITA | MARIETTE -> HARRIETTE )
ANJANETTA	( JEANETTA | JEANETTE -> ANJANETTE )
SHANETTA	( JEANETTA | JEANELLE -> SHANELLE )
CHANETTA	( JEANETTA | JEANELLE -> CHANELLE )
PEARA	( SHARA | SHARLENE -> PEARLENE )
DANNIELLA	( DANIELLA | DANIELLE -> DANNIELLE )
JACQUERITE	( MARQUERITE | MARQUETTA -> JACQUETTA )
CLARETTE	( MARGARETTE | MARGARETTA -> CLARETTA )
STEPHINA	( JOSEPHINA | JOSEPHINE -> STEPHINE )
JEANNI	( JENNI | JENNETTE -> JEANNETTE )
LYNNI	( JENNI | JENNETTE -> LYNNETTE )
JANNI	( JENNI | JENNETTE -> JANNETTE )
JENI	( JENNI | JENNIFFER -> JENIFFER )
NANNI	( JENNI | JENNETTE -> NANNETTE )
DANNI	( JENNI | JENNETTE -> DANNETTE )
DONNI	( JENNI | JENNETTE -> DONNETTE )
MARIANE	( ADRIANE | ADRIANNE -> MARIANNE )
ANJANE	( JEANE | JEANETTE -> ANJANETTE )
CHANE	( JEANE | JEANELLE -> CHANELLE )
JOSEPHAINE	( STEPHAINE | STEPHINE -> JOSEPHINE )
JEANIKA	( SHANIKA | SHANELLE -> JEANELLE )
ADRIBETH	( MARIBETH | MARIANNE -> ADRIANNE )
HENRIBETH	( MARIBETH | MARIETTA -> HENRIETTA )
GABRIBETH	( MARIBETH | MARIELLE -> GABRIELLE )
HARRIBETH	( MARIBETH | MARIETTE -> HARRIETTE )
JOSEPHANI	( STEPHANI | STEPHINE -> JOSEPHINE )
CLEMENE	( FLORENE | FLORENTINA -> CLEMENTINA )
ARGENE	( FLORENE | FLORENTINA -> ARGENTINA )
JEANTELLE	( CHANTELLE | CHANELLE -> JEANELLE )
PEARISSA	( CHARISSA | CHARLENE -> PEARLENE )
CLARETE	( MARGARETE | MARGARETTA -> CLARETTA )
ALESSIDY	( CASSIDY | CASSANDRA -> ALESSANDRA )
DOMONA	( VERONA | VERONIQUE -> DOMONIQUE )
JEANNAN	( SHANNAN | SHANELLE -> JEANELLE )
LARRETTA	( LORRETTA | LORRAINE -> LARRAINE )
KYMBERELY	( KIMBERELY | KIMBERLY -> KYMBERLY )
KEMBERELY	( KIMBERELY | KIMBERLY -> KEMBERLY )
DANNICA	( DANICA | DANIELLE -> DANNIELLE )
PEARLETTE	( CHARLETTE | CHARLENE -> PEARLENE )
CLARLETTE	( CHARLETTE | CHARISSA -> CLARISSA )
JEANTELL	( SHANTELL | SHANELLE -> JEANELLE )
PEAROLETTE	( CHAROLETTE | CHARLENE -> PEARLENE )
CLAROLETTE	( CHAROLETTE | CHARISSA -> CLARISSA )
JEANELL	( SHANELL | SHANELLE -> JEANELLE )
JEANNIFFER	( JENNIFFER | JENNETTE -> JEANNETTE )
LYNNIFFER	( JENNIFFER | JENNETTE -> LYNNETTE )
JANNIFFER	( JENNIFFER | JENNETTE -> JANNETTE )
NANNIFFER	( JENNIFFER | JENNETTE -> NANNETTE )
DANNIFFER	( JENNIFFER | JENNETTE -> DANNETTE )
DONNIFFER	( JENNIFFER | JENNETTE -> DONNETTE )
ADRIELA	( MARIELA | MARIANNE -> ADRIANNE )
HENRIELA	( MARIELA | MARIETTA -> HENRIETTA )
HARRIELA	( MARIELA | MARIETTE -> HARRIETTE )
JEANITA	( SHANITA | SHANELLE -> JEANELLE )
JEANI	( SHANI | SHANELLE -> JEANELLE )
ADRILOU	( MARILOU | MARIANNE -> ADRIANNE )
HENRILOU	( MARILOU | MARIETTA -> HENRIETTA )
GABRILOU	( MARILOU | MARIELLE -> GABRIELLE )
HARRILOU	( MARILOU | MARIETTE -> HARRIETTE )
DANNIELE	( DANIELE | DANIELLE -> DANNIELLE )
LYNNIELLE	( DANNIELLE | DANNETTE -> LYNNETTE )
JENNIELLE	( DANNIELLE | DANNETTE -> JENNETTE )
DONNIELLE	( DANNIELLE | DANNETTE -> DONNETTE )
PEAREN	( SHAREN | SHARLENE -> PEARLENE )
PEAREE	( SHAREE | SHARLENE -> PEARLENE )
CHARIBEL	( CLARIBEL | CLARISSA -> CHARISSA )
MARGARIBEL	( CLARIBEL | CLARETTA -> MARGARETTA )
ANTIONINA	( ANTONINA | ANTONETTE -> ANTIONETTE )
STEFFINY	( TIFFINY | TIFFANIE -> STEFFANIE )
CHAROLASA	( NICOLASA | NICOLETTE -> CHAROLETTE )
VIOLASA	( NICOLASA | NICOLETTE -> VIOLETTE )
ROCHOL	( NICHOL | NICHELLE -> ROCHELLE )
RACHOL	( NICHOL | NICHELLE -> RACHELLE )
MECHOL	( NICHOL | NICHELLE -> MECHELLE )
MACHOL	( NICHOL | NICHELLE -> MACHELLE )
LACHOL	( NICHOL | NICHELLE -> LACHELLE )
MARCHOL	( NICHOL | NICHELLE -> MARCHELLE )
CLARETT	( MARGARETT | MARGARETTA -> CLARETTA )
KYMBERLI	( KIMBERLI | KIMBERLY -> KYMBERLY )
KEMBERLI	( KIMBERLI | KIMBERLY -> KEMBERLY )
DANNIA	( DANIA | DANIELLE -> DANNIELLE )
PEARITA	( SHARITA | SHARLENE -> PEARLENE )
CLARITE	( MARGARITE | MARGARETTA -> CLARETTA )
MAGDALYN	( MADALYN | MADALENE -> MAGDALENE )
MARIELE	( GABRIELE | GABRIELLE -> MARIELLE )
JOSEPHANE	( STEPHANE | STEPHINE -> JOSEPHINE )
EARNESTINA	( CELESTINA | CELESTINE -> EARNESTINE )
CHARLE	( PEARLE | PEARLENE -> CHARLENE )
SHARLE	( PEARLE | PEARLENE -> SHARLENE )
CHAROLLE	( NICOLLE | NICOLETTE -> CHAROLETTE )
VIOLLE	( NICOLLE | NICOLETTE -> VIOLETTE )
RICHELL	( RACHELL | RACHELLE -> RICHELLE )
NICHELL	( RACHELL | RACHELLE -> NICHELLE )
ROCHIKO	( MICHIKO | MICHELLE -> ROCHELLE )
RACHIKO	( MICHIKO | MICHELLE -> RACHELLE )
MECHIKO	( MICHIKO | MICHELLE -> MECHELLE )
MACHIKO	( MICHIKO | MICHELLE -> MACHELLE )
LACHIKO	( MICHIKO | MICHELLE -> LACHELLE )
MARCHIKO	( MICHIKO | MICHELLE -> MARCHELLE )
ANNAMOND	( ROSAMOND | ROSAMARIA -> ANNAMARIA )
ANAMOND	( ROSAMOND | ROSAMARIA -> ANAMARIA )
JAQULYN	( JACQULYN | JACQUELINE -> JAQUELINE )
JACKQULYN	( JACQULYN | JACQUELINE -> JACKQUELINE )
MARQULYN	( JACQULYN | JACQUETTA -> MARQUETTA )
JEANEKA	( SHANEKA | SHANELLE -> JEANELLE )
JENNISE	( JENISE | JENIFFER -> JENNIFFER )
MAGDALINE	( MADALINE | MADALENE -> MAGDALENE )
RODERICA	( FREDERICA | FREDERICK -> RODERICK )
BRODERICA	( FREDERICA | FREDERICK -> BRODERICK )
RICHELE	( RACHELE | RACHELLE -> RICHELLE )
NICHELE	( RACHELE | RACHELLE -> NICHELLE )
ADRIEL	( MARIEL | MARIANNE -> ADRIANNE )
HENRIEL	( MARIEL | MARIETTA -> HENRIETTA )
HARRIEL	( MARIEL | MARIETTE -> HARRIETTE )
KYMBER	( KIMBER | KIMBERLY -> KYMBERLY )
KEMBER	( KIMBER | KIMBERLY -> KEMBERLY )
JEANNEFER	( JENNEFER | JENNETTE -> JEANNETTE )
LYNNEFER	( JENNEFER | JENNETTE -> LYNNETTE )
JANNEFER	( JENNEFER | JENNETTE -> JANNETTE )
NANNEFER	( JENNEFER | JENNETTE -> NANNETTE )
DANNEFER	( JENNEFER | JENNETTE -> DANNETTE )
DONNEFER	( JENNEFER | JENNETTE -> DONNETTE )
COLLIA	( WILLIA | WILLETTE -> COLLETTE )
WILLEN	( COLLEN | COLLETTE -> WILLETTE )
ROCHELINE	( MICHELINE | MICHELLE -> ROCHELLE )
RACHELINE	( MICHELINE | MICHELLE -> RACHELLE )
MECHELINE	( MICHELINE | MICHELLE -> MECHELLE )
MACHELINE	( MICHELINE | MICHELLE -> MACHELLE )
LACHELINE	( MICHELINE | MICHELLE -> LACHELLE )
MARCHELINE	( MICHELINE | MICHELLE -> MARCHELLE )
RODERICKA	( FREDERICKA | FREDERICK -> RODERICK )
BRODERICKA	( FREDERICKA | FREDERICK -> BRODERICK )
MARGUETTA	( MARQUETTA | MARQUERITE -> MARGUERITE )
CLART	( MARGART | MARGARETTA -> CLARETTA )
PEARYL	( SHARYL | SHARLENE -> PEARLENE )
ANJANENE	( JEANENE | JEANETTE -> ANJANETTE )
SHANENE	( JEANENE | JEANELLE -> SHANELLE )
CHANENE	( JEANENE | JEANELLE -> CHANELLE )
JAQUALINE	( JACQUALINE | JACQUELINE -> JAQUELINE )
JACKQUALINE	( JACQUALINE | JACQUELINE -> JACKQUELINE )
MARQUALINE	( JACQUALINE | JACQUETTA -> MARQUETTA )
ANTIONIETTA	( ANTONIETTA | ANTONETTE -> ANTIONETTE )
ROSAMAE	( ANNAMAE | ANNAMARIA -> ROSAMARIA )
CHAROL	( NICOL | NICOLETTE -> CHAROLETTE )
VIOL	( NICOL | NICOLETTE -> VIOLETTE )
JAQUELYNN	( JACQUELYNN | JACQUELINE -> JAQUELINE )
JACKQUELYNN	( JACQUELYNN | JACQUELINE -> JACKQUELINE )
MARQUELYNN	( JACQUELYNN | JACQUETTA -> MARQUETTA )
PEARISE	( CHARISE | CHARLENE -> PEARLENE )
CLARISE	( CHARISE | CHARISSA -> CLARISSA )
KYMBERLIE	( KIMBERLIE | KIMBERLY -> KYMBERLY )
KEMBERLIE	( KIMBERLIE | KIMBERLY -> KEMBERLY )
CHARINE	( CLARINE | CLARISSA -> CHARISSA )
MARGARINE	( CLARINE | CLARETTA -> MARGARETTA )
MARYBELL	( MAYBELL | MAYBELLE -> MARYBELLE )
MARQUERITA	( MARGUERITA | MARGUERITE -> MARQUERITE )
CLARETA	( MARGARETA | MARGARETTA -> CLARETTA )
DANNIKA	( DANIKA | DANIELLE -> DANNIELLE )
KYMBERY	( KIMBERY | KIMBERLY -> KYMBERLY )
KEMBERY	( KIMBERY | KIMBERLY -> KEMBERLY )
JAQUELYNE	( JACQUELYNE | JACQUELINE -> JAQUELINE )
JACKQUELYNE	( JACQUELYNE | JACQUELINE -> JACKQUELINE )
MARQUELYNE	( JACQUELYNE | JACQUETTA -> MARQUETTA )
ADRILU	( MARILU | MARIANNE -> ADRIANNE )
HENRILU	( MARILU | MARIETTA -> HENRIETTA )
GABRILU	( MARILU | MARIELLE -> GABRIELLE )
HARRILU	( MARILU | MARIETTE -> HARRIETTE )
JENNICE	( JENICE | JENIFFER -> JENNIFFER )
JAQUILINE	( JACQUILINE | JACQUELINE -> JAQUELINE )
JACKQUILINE	( JACQUILINE | JACQUELINE -> JACKQUELINE )
MARQUILINE	( JACQUILINE | JACQUETTA -> MARQUETTA )
MADALEN	( MAGDALEN | MAGDALENE -> MADALENE )
MARIENE	( ADRIENE | ADRIANNE -> MARIANNE )
ADRINDA	( MARINDA | MARIANNE -> ADRIANNE )
HENRINDA	( MARINDA | MARIETTA -> HENRIETTA )
GABRINDA	( MARINDA | MARIELLE -> GABRIELLE )
HARRINDA	( MARINDA | MARIETTE -> HARRIETTE )
ADRIKO	( MARIKO | MARIANNE -> ADRIANNE )
HENRIKO	( MARIKO | MARIETTA -> HENRIETTA )
GABRIKO	( MARIKO | MARIELLE -> GABRIELLE )
HARRIKO	( MARIKO | MARIETTE -> HARRIETTE )
LYNNET	( JANNET | JANNETTE -> LYNNETTE )
JENNET	( JANNET | JANNETTE -> JENNETTE )
DONNET	( JANNET | JANNETTE -> DONNETTE )
DANNIELL	( DANIELL | DANIELLE -> DANNIELLE )
PEARRI	( SHARRI | SHARLENE -> PEARLENE )
ADRIVEL	( MARIVEL | MARIANNE -> ADRIANNE )
HENRIVEL	( MARIVEL | MARIETTA -> HENRIETTA )
GABRIVEL	( MARIVEL | MARIELLE -> GABRIELLE )
HARRIVEL	( MARIVEL | MARIETTE -> HARRIETTE )
JAQUIE	( JACQUIE | JACQUELINE -> JAQUELINE )
JACKQUIE	( JACQUIE | JACQUELINE -> JACKQUELINE )
MARQUIE	( JACQUIE | JACQUETTA -> MARQUETTA )
DANNILLE	( DANILLE | DANIELLE -> DANNIELLE )
COLLIEMAE	( WILLIEMAE | WILLETTE -> COLLETTE )
JONA	( JOHNA | JOHNATHAN -> JONATHAN )
ANJANMARIE	( JEANMARIE | JEANETTE -> ANJANETTE )
SHANMARIE	( JEANMARIE | JEANELLE -> SHANELLE )
CHANMARIE	( JEANMARIE | JEANELLE -> CHANELLE )
ADRICA	( MARICA | MARIANNE -> ADRIANNE )
HENRICA	( MARICA | MARIETTA -> HENRIETTA )
GABRICA	( MARICA | MARIELLE -> GABRIELLE )
HARRICA	( MARICA | MARIETTE -> HARRIETTE )
STEFFANEY	( TIFFANEY | TIFFANIE -> STEFFANIE )
PEARIE	( SHARIE | SHARLENE -> PEARLENE )
JEANAE	( SHANAE | SHANELLE -> JEANELLE )
ANJANELLE	( JEANELLE | JEANETTE -> ANJANETTE )
LARRIANE	( LORRIANE | LORRAINE -> LARRAINE )
ANJANICE	( JEANICE | JEANETTE -> ANJANETTE )
CHANICE	( JEANICE | JEANELLE -> CHANELLE )
JOSEPHANIA	( STEPHANIA | STEPHINE -> JOSEPHINE )
ADRISHA	( MARISHA | MARIANNE -> ADRIANNE )
HENRISHA	( MARISHA | MARIETTA -> HENRIETTA )
GABRISHA	( MARISHA | MARIELLE -> GABRIELLE )
HARRISHA	( MARISHA | MARIETTE -> HARRIETTE )
ADRIETTE	( MARIETTE | MARIANNE -> ADRIANNE )
GABRIETTE	( MARIETTE | MARIELLE -> GABRIELLE )
ALESSONDRA	( CASSONDRA | CASSANDRA -> ALESSANDRA )
CASAUNDRA	( CASSAUNDRA | CASSANDRA -> CASANDRA )
KASAUNDRA	( CASSAUNDRA | CASSANDRA -> KASANDRA )
LASAUNDRA	( CASSAUNDRA | CASSANDRA -> LASANDRA )
ALESSAUNDRA	( CASSAUNDRA | CASSANDRA -> ALESSANDRA )
LISAUNDRA	( CASSAUNDRA | CASSANDRA -> LISANDRA )
CHARLY	( PEARLY | PEARLENE -> CHARLENE )
SHARLY	( PEARLY | PEARLENE -> SHARLENE )
ANJANETT	( JEANETT | JEANETTE -> ANJANETTE )
SHANETT	( JEANETT | JEANELLE -> SHANELLE )
CHANETT	( JEANETT | JEANELLE -> CHANELLE )
ERNESTA	( CELESTA | CELESTINE -> ERNESTINE )
EARNESTA	( CELESTA | CELESTINE -> EARNESTINE )
JOSEPANIE	( STEPANIE | STEPHINE -> JOSEPHINE )
PEARAN	( SHARAN | SHARLENE -> PEARLENE )
JEANIQUA	( SHANIQUA | SHANELLE -> JEANELLE )
ROCHELINA	( MICHELINA | MICHELLE -> ROCHELLE )
RACHELINA	( MICHELINA | MICHELLE -> RACHELLE )
MECHELINA	( MICHELINA | MICHELLE -> MECHELLE )
MACHELINA	( MICHELINA | MICHELLE -> MACHELLE )
LACHELINA	( MICHELINA | MICHELLE -> LACHELLE )
MARCHELINA	( MICHELINA | MICHELLE -> MARCHELLE )
ADRIN	( MARIN | MARIANNE -> ADRIANNE )
HENRIN	( MARIN | MARIETTA -> HENRIETTA )
GABRIN	( MARIN | MARIELLE -> GABRIELLE )
HARRIN	( MARIN | MARIETTE -> HARRIETTE )
JANNINE	( JENNINE | JENNETTE -> JANNETTE )
NANNINE	( JENNINE | JENNETTE -> NANNETTE )
DANNINE	( JENNINE | JENNETTE -> DANNETTE )
JAQUETTA	( JACQUETTA | JACQUELINE -> JAQUELINE )
JACKQUETTA	( JACQUETTA | JACQUELINE -> JACKQUELINE )
PEARIS	( CHARIS | CHARLENE -> PEARLENE )
MARIEN	( ADRIEN | ADRIANNE -> MARIANNE )
PEARDA	( SHARDA | SHARLENE -> PEARLENE )
RICHAL	( RACHAL | RACHELLE -> RICHELLE )
NICHAL	( RACHAL | RACHELLE -> NICHELLE )
ROCHAELE	( MICHAELE | MICHELLE -> ROCHELLE )
RACHAELE	( MICHAELE | MICHELLE -> RACHELLE )
MECHAELE	( MICHAELE | MICHELLE -> MECHELLE )
MACHAELE	( MICHAELE | MICHELLE -> MACHELLE )
LACHAELE	( MICHAELE | MICHELLE -> LACHELLE )
MARCHAELE	( MICHAELE | MICHELLE -> MARCHELLE )
ADRINE	( MARINE | MARIANNE -> ADRIANNE )
HENRINE	( MARINE | MARIETTA -> HENRIETTA )
GABRINE	( MARINE | MARIELLE -> GABRIELLE )
HARRINE	( MARINE | MARIETTE -> HARRIETTE )
CHARETHA	( CLARETHA | CLARISSA -> CHARISSA )
MARGARETHA	( CLARETHA | CLARETTA -> MARGARETTA )
PEARLYN	( CHARLYN | CHARLENE -> PEARLENE )
CLARLYN	( CHARLYN | CHARISSA -> CLARISSA )
PEAROLYN	( SHAROLYN | SHARLENE -> PEARLENE )
PEARILYN	( SHARILYN | SHARLENE -> PEARLENE )
JEANTAY	( SHANTAY | SHANELLE -> JEANELLE )
JACQUITTA	( MARQUITTA | MARQUETTA -> JACQUETTA )
LYNNETTA	( DONNETTA | DONNETTE -> LYNNETTE )
JANNETTA	( DONNETTA | DONNETTE -> JANNETTE )
NANNETTA	( DONNETTA | DONNETTE -> NANNETTE )
JENNETTA	( DONNETTA | DONNETTE -> JENNETTE )
DANNETTA	( DONNETTA | DONNETTE -> DANNETTE )
CHARISA	( CLARISA | CLARISSA -> CHARISSA )
MARGARISA	( CLARISA | CLARETTA -> MARGARETTA )
PEARLESETTA	( CHARLESETTA | CHARLENE -> PEARLENE )
CLARLESETTA	( CHARLESETTA | CHARISSA -> CLARISSA )
ALESSY	( CASSY | CASSANDRA -> ALESSANDRA )
ALESSI	( CASSI | CASSANDRA -> ALESSANDRA )
ANTIONETTA	( ANTONETTA | ANTONETTE -> ANTIONETTE )
PEARICE	( SHARICE | SHARLENE -> PEARLENE )
ADRIS	( MARIS | MARIANNE -> ADRIANNE )
GABRIS	( MARIS | MARIELLE -> GABRIELLE )
PEARLOTT	( CHARLOTT | CHARLENE -> PEARLENE )
CLARLOTT	( CHARLOTT | CHARISSA -> CLARISSA )
COLLODEAN	( WILLODEAN | WILLETTE -> COLLETTE )
JEANTI	( SHANTI | SHANELLE -> JEANELLE )
JAQUI	( JACQUI | JACQUELINE -> JAQUELINE )
JACKQUI	( JACQUI | JACQUELINE -> JACKQUELINE )
MARQUI	( JACQUI | JACQUETTA -> MARQUETTA )
MARGARIS	( CLARIS | CLARETTA -> MARGARETTA )
JERMAIN	( CHARMAIN | CHARMAINE -> JERMAINE )
PEARMAIN	( CHARMAIN | CHARLENE -> PEARLENE )
CLARMAIN	( CHARMAIN | CHARISSA -> CLARISSA )
GERMAIN	( CHARMAIN | CHARMAINE -> GERMAINE )
COLLETTA	( WILLETTA | WILLETTE -> COLLETTE )
ADRIELLE	( MARIELLE | MARIANNE -> ADRIANNE )
HENRIELLE	( MARIELLE | MARIETTA -> HENRIETTA )
HARRIELLE	( MARIELLE | MARIETTE -> HARRIETTE )
ADRIELLA	( MARIELLA | MARIANNE -> ADRIANNE )
HENRIELLA	( MARIELLA | MARIETTA -> HENRIETTA )
HARRIELLA	( MARIELLA | MARIETTE -> HARRIETTE )
ADRIANELA	( MARIANELA | MARIANNE -> ADRIANNE )
HENRIANELA	( MARIANELA | MARIETTA -> HENRIETTA )
GABRIANELA	( MARIANELA | MARIELLE -> GABRIELLE )
HARRIANELA	( MARIANELA | MARIETTE -> HARRIETTE )
CASSABETH	( LISABETH | LISANDRA -> CASSANDRA )
CASABETH	( LISABETH | LISANDRA -> CASANDRA )
KASSABETH	( LISABETH | LISANDRA -> KASSANDRA )
KASABETH	( LISABETH | LISANDRA -> KASANDRA )
LASABETH	( LISABETH | LISANDRA -> LASANDRA )
ALESSABETH	( LISABETH | LISANDRA -> ALESSANDRA )
CHARINDA	( CLARINDA | CLARISSA -> CHARISSA )
MARGARINDA	( CLARINDA | CLARETTA -> MARGARETTA )
COLLOW	( WILLOW | WILLETTE -> COLLETTE )
COLLENA	( WILLENA | WILLETTE -> COLLETTE )
JOSEPHNIE	( STEPHNIE | STEPHINE -> JOSEPHINE )
PEARIKA	( SHARIKA | SHARLENE -> PEARLENE )
ADRICRUZ	( MARICRUZ | MARIANNE -> ADRIANNE )
HENRICRUZ	( MARICRUZ | MARIETTA -> HENRIETTA )
GABRICRUZ	( MARICRUZ | MARIELLE -> GABRIELLE )
HARRICRUZ	( MARICRUZ | MARIETTE -> HARRIETTE )
CHARETTA	( CLARETTA | CLARISSA -> CHARISSA )
PEARLSIE	( CHARLSIE | CHARLENE -> PEARLENE )
CLARLSIE	( CHARLSIE | CHARISSA -> CLARISSA )
PEARLENA	( CHARLENA | CHARLENE -> PEARLENE )
CLARLENA	( CHARLENA | CHARISSA -> CLARISSA )
JEANTAE	( SHANTAE | SHANELLE -> JEANELLE )
JEANDI	( SHANDI | SHANELLE -> JEANELLE )
ROCHOLLE	( NICHOLLE | NICHELLE -> ROCHELLE )
RACHOLLE	( NICHOLLE | NICHELLE -> RACHELLE )
MECHOLLE	( NICHOLLE | NICHELLE -> MECHELLE )
MACHOLLE	( NICHOLLE | NICHELLE -> MACHELLE )
LACHOLLE	( NICHOLLE | NICHELLE -> LACHELLE )
MARCHOLLE	( NICHOLLE | NICHELLE -> MARCHELLE )
KYMBRA	( KIMBRA | KIMBERLY -> KYMBERLY )
KEMBRA	( KIMBRA | KIMBERLY -> KEMBERLY )
DOMONIKA	( VERONIKA | VERONIQUE -> DOMONIQUE )
PEARELL	( SHARELL | SHARLENE -> PEARLENE )
ROCHA	( MICHA | MICHELLE -> ROCHELLE )
RACHA	( MICHA | MICHELLE -> RACHELLE )
MECHA	( MICHA | MICHELLE -> MECHELLE )
MACHA	( MICHA | MICHELLE -> MACHELLE )
LACHA	( MICHA | MICHELLE -> LACHELLE )
MARCHA	( MICHA | MICHELLE -> MARCHELLE )
LARRINE	( LORRINE | LORRAINE -> LARRAINE )
ANJANNETTA	( JEANNETTA | JEANETTE -> ANJANETTE )
SHANNETTA	( JEANNETTA | JEANELLE -> SHANELLE )
CHANNETTA	( JEANNETTA | JEANELLE -> CHANELLE )
ADALBERTE	( GILBERTE | GILBERTO -> ADALBERTO )
ALESSEY	( CASSEY | CASSANDRA -> ALESSANDRA )